XXXXXXXXXXXXXXXX
X              X
X              X
X              X
X              X
X              X
X              X
X              X
X              X
X              X
X              X
X              X
X              X
X              X
X              X
X              X
X   S          X
X   1          X
X              X
X              X
X              X
X              X
X              X
XXXXXXXXXXXXXXXX

