XXXXXXXXXXXXXXXXXXXXXXXX
XXXXX                  X
X            XX      X X
X    XXXXXXXXXX      X X
X             X      X X
X    XXXXXXXXXX      X X
X             X      X X
XXXXXXXXXXXXXXX   B  X X
X     X              X X
X     XXXX XXXX  F   X X
X             X  F   X X
XXXXXXX XXXXXXX  F   X X
X             X  F   X X
X             X      X X
X   43210S F  X        X
XXXXXXXXXXXXXXXXXXXXXXXX