XXXXXXXXXXXXXXXX
XXXXX          X
X            X X
X    XXXXXXXXX X
X              X
X    XXXXXXXXX X
X              X
XXXXXXXXXXXXXX X
X              X
X     XXXX XXX X
X              X
XXXXXXX XXXXXXDX
X              X
X  F F F F F   X
X             [X
X    B B B     X
X     B B      X
X              X
X              X
X              X
X              X
X              X
X   43210S     X
XXXXXXXXXXXXXXXX

{"x": 15, "y": 12, "activators": [{"x": 15, "y": 15}]}